
000000000011000000000000000111000000000000111111110000000000
111000110000000000011111000000001111100011111111111000000000
111111110000011111111111111000111100000011100000111110000000
111110000011111111111111111111111110000000000001111111110000
111100000011101111111111111111111111100000000001111111111110
111000111111111100000000000001111111111111111111111111111111
111111111100011111111100111111111111111111111111111111111111
111111111111111111111111111111111111111111111111111111111111
111111111111111111111111111111111111111111111111111111111111
111111111111111111111111111111111111111111111111111111111111
111111111111111111111111111111111111111111111111111111111111
111111111111111111111111111111111111111111111111111111111111
