000000000000000
000001110000000
000000000011100
001110000000000
000000111000000
000001111100000
000000000001110
011100001110000
000000000000111
001110000000000
000000111100000
000011000011000
000000000000000
000001110000000
011100000000000
000000001110000
000111000000000
000000000011100
000000111000000
001110000000000
000000000000000
000001110000000
000000000011100
000000000000000
111111111111111